##################################################
#................................................#
#.....SSSS.......................................#
#.....SSSS.......................................#
#................................................#
#..........^^^^^^^^^^^^^^.........T..............#
#..........^^^^^^^^^^^^^^........................#
#..........^^^^^^^^^^^^^^........................#
#................................................#
#.T............................................>.#
#................................................#
##################################################
