##################################################
#,,,,,,,,,,,,,,,,,,,,,,,,,,,,,,,,,,,,,,,,,,,,,,,,#
#,,######################,,######################,#
#,,#...................,#,,#,..................#,#
#,,#..S..,,,,,,,,,,,,,,###,,###,,,,,,,,,,,,,S..,#,#
#,,#,,,,,,,,,,,,,,,,,,,#~~~~~~#,,,,,,,,,,,,,,,,,#,#
#,,#,,,,,,,,,,,,,,,,,,,#~~~~~~#,,,,,,,,,,,,,,,,,#,#
#,,####,,,,,,,,,,####,=#~~~~~~#=,####,,,,,,,,####,#
#,,,,,#,,,,,,,,,,#,,,,,,======,,,,,#,,,,,,,,,,#,,,#
#,,,,,#,,,,,,,,,,#,,,,,,,,,,,,,,,,#,,,,,,,,,,#,,,#
#,,,,,############,,,,########,,,,############,,,#
#,,,,,,,,,,,,,,,,,,,,,,,,,,,,,,,,,,,,,,,,,,,,,,,,#
#........*................................*......#
#....########....########....########....########,#
#....#,,,,,,#....#,,,,,,#....#,,,,,,#....#,,,,,,#,#
#....#,,,,,,#....#,,,,,,#....#,,,,,,#....#,,,,,,#,#
#....#,,S,,,#....#,,S,,,#....#,,S,,,#....#,,S,,,#,#
#....#,,,,,,#....#,,,,,,#....#,,,,,,#....#,,,,,,#,#
#....#,,,,,,#....#,,,,,,#....#,,,,,,#....#,,,,,,#,#
#....########....########....########....########,#
#,,,,,,,,,,,,,,,,,,,,,,,,,,,,,,,,,,,,,,,,,,,,,,,,#
#,,,,,,,,,,~~~~~~,,,,%%,,,,,,%%,,,,~~~~~~,,,,,,,,#
#,,######################,,######################,#
#,,#........O.......,#,,#,........O.........#,#
#,,#.................###,,###.................#,#
#,,#...,,,,,,,,,,,,,,#,,,,,,#,,,,,,,,,,,,,....,#,#
#,,#...,,,,^^^^^^,,,,#,,,,,,#,,,,^^^^^^,,,....,#,#
#,,####,,,,^^^^^^####,#,,,,,,#,####^^^^^^,,####,#
#,,,,,#,,,,======,,,,,,,,,,,,,,,,,,======,,#,,,#
#,,,,,#,,,,,,,,,,#,,,,,,,,,,,,,,#,,,,,,,,,,#,,,#
#,,,,,############,,,,########,,,,############,,,#
#,,,,,,,,,,,,,,,,,,,,,,,,,,,,,,,,,,,,,,,,,,,,,,,,#
##################################################
